
R   500 500
NO images/redbrick.xpm
SO images/wood.xpm
WE images/greystone.xpm
EA images/mossy.xpm


S images/pillar.xpm

F 255,204,229
C 204,255,255


111111111111111111111111111111
100000000000100000000011111111
100000000000100001001000000001
100011111110100001001000000001
100000000000100001001000011111
111110020000000001001111110001
100010001100000001000000010001
100010001100100N00000000000001
100010000000100001000000010001
100010000000100001110000011111
102010001100100001110000010001
100000001100000101111000010001
100010001100000100001000000001
100010001100000100201000010201
111111111110011000001000010001
100000000000001000001000011111
100011110000001000001000010001
100011110000000000000000010001
100000000000030000000000010001
111111111111111111111111111111
