R  800 800

NO images/redbrick.xpm
SO   images/wood.xpm
WE images/greys tone.xpm
EA images/mossy.xpm
S images/pillar.xpm


F 255,204,1 787
C 204,255,255



        1111111111111111111111111
        10000E0000110000000000001
        1011000001110000002000001
        1001000000000000000000001
111111111011000001110000000000001
100000000011000001110111111111111
11110111111111011100000010001
11110111111111011101010010001
11000000110101011100000010001
10002000000000001100000010001
10002000000000001101010010001
1100200111010101111101111000111
11112111 1110101 101111010001
11111111 1111111 111111111111