R   600 400
NO images/redbrick.xpm
SO images/wood.xpm
WE images/greystone.xpm
EA images/mossy.xpm

S images/pillar.xpm

F 255,204,229
C 204,255,255

111111111111111111111111
100000000000000000000001
100000000000000000000001
100000000000000000000001
100000112110000101010001
100000100010000000000001
100000100010000100010001
100000100010000000000001
100000110110000101010001
100000000000000000000001
100000000000000000000001
100000000000000000000001
100000000000000000000001
100000000000000000000001
100000000000000000000001
100003330000000000000001
111111111111111111111111